111111000111111
100000000000001
100000000000001
100000000000001
100000000000001
100000000000001
000000000000000
000000000000000
000000000000000
100000000000001
100000000000001
100000000000001
100000000000001
100000000000001
111111111111111