111111000111111
100000000000001
100000000000001
100000000000001
100000000000001
100000000000001
100000000000000
400000000000000
100000000000000
100000000000001
100000000000001
100000000000001
100000000000001
100000000000001
111111111111111