111111000111111
100000000000001
100000000000001
100000000000001
100000000000001
100000000000001
000000111000000
000000111000000
000000111000000
100000000000001
100000000000001
100000000000001
100000000000001
100000000000001
111111000111111