111111121111111
100000000000001
100000000000001
100000000000001
100000000000001
100000000000001
100000000000001
100000000000002
100000000000001
100000000000004
100000000000001
100000000000001
100000000000001
100000000000001
111111111111111